XXXXXXXXXXXXXXXXXXXXXXXXXXXXXXXXXXXXXXXXXXXXXXXXXXXXXXXXXXXXXXXXXXXXXXXXXXXXXXXX
XXXXXXXXXXXXXXXXXXXXXXXXXXXXXXXXXXXXXXXXXXXXXXXXXXXXXXXXXXXXXXXXXXXXXXXXXXXXXXXX
XXRRRRRRRRRRRRRRRRRRRRRRRRRRRRRRRRRRRRXXXXRRRRRRRRRRRRRRRRRRRRRRRRRRRRRRRRRRRRXX
XXRRRRRRRRRRRRRRRRRRRRRRRRRRRRRRRRRRRRXXXXRRRRRRRRRRRRRRRRRRRRRRRRRRRRRRRRRRRRXX
XXRRXXXXXXXXXXXXXXRRRXXXXXXXXXXXXXXXRRXXXXRRXXXXXXXXXXXXXXRRRXXXXXXXXXXXXXXXRRXX
XXRRXXXXXXXXXXXXXXRRRXXXXXXXXXXXXXXXRRXXXXRRXXXXXXXXXXXXXXRRRXXXXXXXXXXXXXXXRRXX
XXRRXXXXXXXXXXXXXXRRRXXXXXXXXXXXXXXXRRXXXXRRXXXXXXXXXXXXXXRRRXXXXXXXXXXXXXXXRRXX
XXRRXXXXXXXXXXXXXXRRRXXXXXXXXXXXXXXXRRXXXXRRXXXXXXXXXXXXXXRRRXXXXXXXXXXXXXXXRRXX
XXRRXXXXXXXXXXXXXXRRRXXXXXXXXXXXXXXXRRXXXXRRXXXXXXXXXXXXXXRRRXXXXXXXXXXXXXXXRRXX
XXRRXXXXXXXXXXXXXXRRRXXXXXXXXXXXXXXXRRXXXXRRXXXXXXXXXXXXXXRRRXXXXXXXXXXXXXXXRRXX
XXRRXXXXXXXXXXXXXXRRRXXXXXXXXXXXXXXXRRXXXXRRXXXXXXXXXXXXXXRRRXXXXXXXXXXXXXXXRRXX
XXRRXXXXXXXXXXXXXXRRRXXXXXXXXXXXXXXXRRXXXXRRXXXXXXXXXXXXXXRRRXXXXXXXXXXXXXXXRRXX
XXRRXXXXXXXXXXXXXXRRRXXXXXXXXXXXXXXXRRXXXXRRXXXXXXXXXXXXXXRRRXXXXXXXXXXXXXXXRRXX
XXRRXXXXXXXXXXXXXXRRRXXXXXXXXXXXXXXXRRXXXXRRXXXXXXXXXXXXXXRRRXXXXXXXXXXXXXXXRRXX
XXRRXXXXXXXXXXXXXXRRRXXXXXXXXXXXXXXXRRXXXXRRXXXXXXXXXXXXXXRRRXXXXXXXXXXXXXXXRRXX
XXRRXXXXXXXXXXXXXXRRRXXXXXXXXXXXXXXXRRXXXXRRXXXXXXXXXXXXXXRRRXXXXXXXXXXXXXXXRRXX
XXRRXXXXXXXXXXXXXXRRRXXXXXXXXXXXXXXXRRXXXXRRXXXXXXXXXXXXXXRRRXXXXXXXXXXXXXXXRRXX
XXRRXXXXXXXXXXXXXXRRRXXXXXXXXXXXXXXXRRXXXXRRXXXXXXXXXXXXXXRRRXXXXXXXXXXXXXXXRRXX
XXRRXXXXXXXXXXXXXXRRRXXXXXXXXXXXXXXXRRXXXXRRXXXXXXXXXXXXXXRRRXXXXXXXXXXXXXXXRRXX
XXRRXXXXXXXXXXXXXXRRRXXXXXXXXXXXXXXXRRXXXXRRXXXXXXXXXXXXXXRRRXXXXXXXXXXXXXXXRRXX
XXRRXXXXXXXXXXXXXXRRRXXXXXXXXXXXXXXXRRXXXXRRXXXXXXXXXXXXXXRRRXXXXXXXXXXXXXXXRRXX
XXRRXXXXXXXXXXXXXXRRRXXXXXXXXXXXXXXXRRXXXXRRXXXXXXXXXXXXXXRRRXXXXXXXXXXXXXXXRRXX
XXRRXXXXXXXXXXXXXXRRRXXXXXXXXXXXXXXXRRXXXXRRXXXXXXXXXXXXXXRRRXXXXXXXXXXXXXXXRRXX
XXRRXXXXXXXXXXXXXXRRRXXXXXXXXXXXXXXXRRXXXXRRXXXXXXXXXXXXXXRRRXXXXXXXXXXXXXXXRRXX
XXRRXXXXXXXXXXXXXXRRRXXXXXXXXXXXXXXXRRXXXXRRXXXXXXXXXXXXXXRRRXXXXXXXXXXXXXXXRRXX
XXRRXXXXXXXXXXXXXXRRRXXXXXXXXXXXXXXXRRXXXXRRXXXXXXXXXXXXXXRRRXXXXXXXXXXXXXXXRRXX
XXRRXXXXXXXXXXXXXXRRRXXXXXXXXXXXXXXXRRXXXXRRXXXXXXXXXXXXXXRRRXXXXXXXXXXXXXXXRRXX
XXRRXXXXXXXXXXXXXXRRRXXXXXXXXXXXXXXXRRXXXXRRXXXXXXXXXXXXXXRRRXXXXXXXXXXXXXXXRRXX
XXRRXXXXXXXXXXXXXXRRRXXXXXXXXXXXXXXXRRXXXXRRXXXXXXXXXXXXXXRRRXXXXXXXXXXXXXXXRRXX
XXRRXXXXXXXXXXXXXXRRRXXXXXXXXXXXXXXXRRXXXXRRXXXXXXXXXXXXXXRRRXXXXXXXXXXXXXXXRRXX
XXRRXXXXXXXXXXXXXXRRRXXXXXXXXXXXXXXXRRXXXXRRXXXXXXXXXXXXXXRRRXXXXXXXXXXXXXXXRRXX
XXRRXXXXXXXXXXXXXXRRRXXXXXXXXXXXXXXXRRXXXXRRXXXXXXXXXXXXXXRRRXXXXXXXXXXXXXXXRRXX
XXRRXXXXXXXXXXXXXXRRRXXXXXXXXXXXXXXXRRXXXXRRXXXXXXXXXXXXXXRRRXXXXXXXXXXXXXXXRRXX
XXRRXXXXXXXXXXXXXXRRRXXXXXXXXXXXXXXXRRXXXXRRXXXXXXXXXXXXXXRRRXXXXXXXXXXXXXXXRRXX
XXRRXXXXXXXXXXXXXXRRRXXXXXXXXXXXXXXXRRXXXXRRXXXXXXXXXXXXXXRRRXXXXXXXXXXXXXXXRRXX
XXRRXXXXXXXXXXXXXXRRRXXXXXXXXXXXXXXXRRXXXXRRXXXXXXXXXXXXXXRRRXXXXXXXXXXXXXXXRRXX
XXRRRRRRRRRRRRRRRRRRRRRRRRRRRRRRRRRRRRXXXXRRRRRRRRRRRRRRRRRRRRRRRRRRRRRRRRRRRRXX
XXRRRRRRRRRRRRRRRRRRRRRRRRRRRRRRRRRRRRXXXXRRRRRRRRRRRRRRRRRRRRRRRRRRRRRRRRRRRRXX
XXXXXXXXXXXXXXXXXXXXXXXXXXXXXXXXXXXXXXXXXXXXXXXXXXXXXXXXXXXXXXXXXXXXXXXXXXXXXXXX
XXXXXXXXXXXXXXXXXXXXXXXXXXXXXXXXXXXXXXXXXXXXXXXXXXXXXXXXXXXXXXXXXXXXXXXXXXXXXXXX
XXXXXXXXXXXXXXXXXXXXXXXXXXXXXXXXXXXXXXXXXXXXXXXXXXXXXXXXXXXXXXXXXXXXXXXXXXXXXXXX
XXXXXXXXXXXXXXXXXXXXXXXXXXXXXXXXXXXXXXXXXXXXXXXXXXXXXXXXXXXXXXXXXXXXXXXXXXXXXXXX
XXRRRRRRRRRRRRRRRRRRRRRRRRRRRRRRRRRRRRXXXXRRRRRRRRRRRRRRRRRRRRRRRRRRRRRRRRRRRRXX
XXRRRRRRRRRRRRRRRRRRRRRRRRRRRRRRRRRRRRXXXXRRRRRRRRRRRRRRRRRRRRRRRRRRRRRRRRRRRRXX
XXRRXXXXXXXXXXXXXXRRRXXXXXXXXXXXXXXXRRXXXXRRXXXXXXXXXXXXXXRRRXXXXXXXXXXXXXXXRRXX
XXRRXXXXXXXXXXXXXXRRRXXXXXXXXXXXXXXXRRXXXXRRXXXXXXXXXXXXXXRRRXXXXXXXXXXXXXXXRRXX
XXRRXXXXXXXXXXXXXXRRRXXXXXXXXXXXXXXXRRXXXXRRXXXXXXXXXXXXXXRRRXXXXXXXXXXXXXXXRRXX
XXRRXXXXXXXXXXXXXXRRRXXXXXXXXXXXXXXXRRXXXXRRXXXXXXXXXXXXXXRRRXXXXXXXXXXXXXXXRRXX
XXRRXXXXXXXXXXXXXXRRRXXXXXXXXXXXXXXXRRXXXXRRXXXXXXXXXXXXXXRRRXXXXXXXXXXXXXXXRRXX
XXRRXXXXXXXXXXXXXXRRRXXXXXXXXXXXXXXXRRXXXXRRXXXXXXXXXXXXXXRRRXXXXXXXXXXXXXXXRRXX
XXRRXXXXXXXXXXXXXXRRRXXXXXXXXXXXXXXXRRXXXXRRXXXXXXXXXXXXXXRRRXXXXXXXXXXXXXXXRRXX
XXRRXXXXXXXXXXXXXXRRRXXXXXXXXXXXXXXXRRXXXXRRXXXXXXXXXXXXXXRRRXXXXXXXXXXXXXXXRRXX
XXRRXXXXXXXXXXXXXXRRRXXXXXXXXXXXXXXXRRXXXXRRXXXXXXXXXXXXXXRRRXXXXXXXXXXXXXXXRRXX
XXRRXXXXXXXXXXXXXXRRRXXXXXXXXXXXXXXXRRXXXXRRXXXXXXXXXXXXXXRRRXXXXXXXXXXXXXXXRRXX
XXRRXXXXXXXXXXXXXXRRRXXXXXXXXXXXXXXXRRXXXXRRXXXXXXXXXXXXXXRRRXXXXXXXXXXXXXXXRRXX
XXRRXXXXXXXXXXXXXXRRRXXXXXXXXXXXXXXXRRXXXXRRXXXXXXXXXXXXXXRRRXXXXXXXXXXXXXXXRRXX
XXRRXXXXXXXXXXXXXXRRRXXXXXXXXXXXXXXXRRXXXXRRXXXXXXXXXXXXXXRRRXXXXXXXXXXXXXXXRRXX
XXRRXXXXXXXXXXXXXXRRRXXXXXXXXXXXXXXXRRXXXXRRXXXXXXXXXXXXXXRRRXXXXXXXXXXXXXXXRRXX
XXRRXXXXXXXXXXXXXXRRRXXXXXXXXXXXXXXXRRXXXXRRXXXXXXXXXXXXXXRRRXXXXXXXXXXXXXXXRRXX
XXRRXXXXXXXXXXXXXXRRRXXXXXXXXXXXXXXXRRXXXXRRXXXXXXXXXXXXXXRRRXXXXXXXXXXXXXXXRRXX
XXRRXXXXXXXXXXXXXXRRRXXXXXXXXXXXXXXXRRXXXXRRXXXXXXXXXXXXXXRRRXXXXXXXXXXXXXXXRRXX
XXRRXXXXXXXXXXXXXXRRRXXXXXXXXXXXXXXXRRXXXXRRXXXXXXXXXXXXXXRRRXXXXXXXXXXXXXXXRRXX
XXRRXXXXXXXXXXXXXXRRRXXXXXXXXXXXXXXXRRXXXXRRXXXXXXXXXXXXXXRRRXXXXXXXXXXXXXXXRRXX
XXRRXXXXXXXXXXXXXXRRRXXXXXXXXXXXXXXXRRXXXXRRXXXXXXXXXXXXXXRRRXXXXXXXXXXXXXXXRRXX
XXRRXXXXXXXXXXXXXXRRRXXXXXXXXXXXXXXXRRXXXXRRXXXXXXXXXXXXXXRRRXXXXXXXXXXXXXXXRRXX
XXRRXXXXXXXXXXXXXXRRRXXXXXXXXXXXXXXXRRXXXXRRXXXXXXXXXXXXXXRRRXXXXXXXXXXXXXXXRRXX
XXRRXXXXXXXXXXXXXXRRRXXXXXXXXXXXXXXXRRXXXXRRXXXXXXXXXXXXXXRRRXXXXXXXXXXXXXXXRRXX
XXRRXXXXXXXXXXXXXXRRRXXXXXXXXXXXXXXXRRXXXXRRXXXXXXXXXXXXXXRRRXXXXXXXXXXXXXXXRRXX
XXRRXXXXXXXXXXXXXXRRRXXXXXXXXXXXXXXXRRXXXXRRXXXXXXXXXXXXXXRRRXXXXXXXXXXXXXXXRRXX
XXRRXXXXXXXXXXXXXXRRRXXXXXXXXXXXXXXXRRXXXXRRXXXXXXXXXXXXXXRRRXXXXXXXXXXXXXXXRRXX
XXRRXXXXXXXXXXXXXXRRRXXXXXXXXXXXXXXXRRXXXXRRXXXXXXXXXXXXXXRRRXXXXXXXXXXXXXXXRRXX
XXRRXXXXXXXXXXXXXXRRRXXXXXXXXXXXXXXXRRXXXXRRXXXXXXXXXXXXXXRRRXXXXXXXXXXXXXXXRRXX
XXRRXXXXXXXXXXXXXXRRRXXXXXXXXXXXXXXXRRXXXXRRXXXXXXXXXXXXXXRRRXXXXXXXXXXXXXXXRRXX
XXRRXXXXXXXXXXXXXXRRRXXXXXXXXXXXXXXXRRXXXXRRXXXXXXXXXXXXXXRRRXXXXXXXXXXXXXXXRRXX
XXRRXXXXXXXXXXXXXXRRRXXXXXXXXXXXXXXXRRXXXXRRXXXXXXXXXXXXXXRRRXXXXXXXXXXXXXXXRRXX
XXRRXXXXXXXXXXXXXXRRRXXXXXXXXXXXXXXXRRXXXXRRXXXXXXXXXXXXXXRRRXXXXXXXXXXXXXXXRRXX
XXRRRRRRRRRRRRRRRRRRRRRRRRRRRRRRRRRRRRXXXXRRRRRRRRRRRRRRRRRRRRRRRRRRRRRRRRRRRRXX
XXRRRRRRRRRRRRRRRRRRRRRRRRRRRRRRRRRRRRXXXXRRRRRRRRRRRRRRRRRRRRRRRRRRRRRRRRRRRRXX
XXXXXXXXXXXXXXXXXXXXXXXXXXXXXXXXXXXXXXXXXXXXXXXXXXXXXXXXXXXXXXXXXXXXXXXXXXXXXXXX
XXXXXXXXXXXXXXXXXXXXXXXXXXXXXXXXXXXXXXXXXXXXXXXXXXXXXXXXXXXXXXXXXXXXXXXXXXXXXXXX